111111111111111111111111
1E000000000P0000000000C1
100000011100011111100001
100001110000110000100001
100011000000000001100001
10001111100000011000000
1C0000011000001100000001
1000000110000111111000C1
111111111111111111111111

