111111111111111111111111111111111111111
1E00000000000000C00000000000000000000C1
100011100001111110000111111000111100001
10000010000000001000000000100010C100001
100C00100001111110000111111000000100001
10000010000000C010000000001000000100001
100000100001111110000111111000000100001
1000000C00000000000000000000000000000P1
111111111111111111111111111111111111111